NO ./tex/north_wall.xpm
SO ./tex/south_wall.xpm
WE ./tex/west_wall.xpm
EA ./tex/east_wall.xpm

F 255 , 100 , 0
C 225 , 255, 255

     1111111111111111111111111111111111111111111111111111111111111111111111111111
          10000000001100000000000000000000000001110000000000000000000000000111111111111
        11110000011100000000000011100000000000000000000000001110000000000000000000000011
        100100000000000000000000111000000000000000000000000011100000000000000000000000011
11111111101100000111000000000000111000000000000000000000000011100000000000000N00000000001
10000000000000000000000000000000000000000000000000000000000111011111011111111111111111111
111101111111110111000000000000000111111110000000000000000000000000000000000000000001001
1111011111111101100000000000000001      10000000000000000000000000000000001010100100011
11000000110101011100000000000000001     1000000000000000000000000000000000000000100011
1000000000000000000000001000100000011111100000000000111111111111111111111111111111111
10000000000000001101000000000000000000000000000000000000000000000000001
11000001110001011110000000000000000000000000000000000000000001111111111
11110111 1000101 111111000000000000000000000000001111111111111
11111111 1111111 111111111111111111111111111111111