NO ./txtrs/NO.xpm
SO ./txtrs/SO.xpm
WE ./txtrs/WE.xpm
EA ./txtrs/EA.xpm

F 225 , 255, 100
C 10 , 150 , 100

1111111111111111
1000000000000001
100000000000N001
1000000000000001
1000000E01000001
1000000000000001
1000000100000001
1010101000000001
1111111111111111